 static or mobile, X index, y index, type, vision, isEnemy, isWalkable, -- isVertical, eX, eY
1717
010110FTF0000
000020FTF0000
000120FTF0000
000220FTF0000
001120FTF0000
001220FTF0000
001320FTF0000
001620FTF0000
001920FTF0000
010020FTF0000
020320FTF0000
020820FTF0000
021320FTF0000
021420FTF0000
021520FTF0000
031320FTF0000
031720FTF0000
031920FTF0000
040620FTF0000
040820FTF0000
041020FTF0000
041420FTF0000
041820FTF0000
050220FTF0000
050320FTF0000
050920FTF0000
051620FTF0000
051720FTF0000
060120FTF0000
060720FTF0000
061220FTF0000
061320FTF0000
070020FTF0000
070220FTF0000
070620FTF0000
070820FTF0000
071120FTF0000
071320FTF0000
071620FTF0000
071720FTF0000
080020FTF0000
080120FTF0000
080320FTF0000
080420FTF0000
080820FTF0000
081220FTF0000
081620FTF0000
090120FTF0000
090520FTF0000
091620FTF0000
100020FTF0000
100420FTF0000
100720FTF0000
101720FTF0000
110020FTF0000
110620FTF0000
120120FTF0000
120420FTF0000
120820FTF0000
121120FTF0000
121320FTF0000
121620FTF0000
121720FTF0000
130020FTF0000
130420FTF0000
131020FTF0000
131220FTF0000
131420FTF0000
131920FTF0000
140620FTF0000
141020FTF0000
141720FTF0000
141920FTF0000
150020FTF0000
150120FTF0000
150220FTF0000
150520FTF0000
150820FTF0000
151520FTF0000
151620FTF0000
151720FTF0000
160120FTF0000
160320FTF0000
160520FTF0000
160720FTF0000
161120FTF0000
161420FTF0000
161520FTF0000
161720FTF0000
161820FTF0000
161920FTF0000
170020FTF0000
170320FTF0000
170420FTF0000
171120FTF0000
171220FTF0000
171420FTF0000
171520FTF0000
171620FTF0000
171720FTF0000
171920FTF0000
180020FTF0000
180220FTF0000
180320FTF0000
180420FTF0000
181420FTF0000
181520FTF0000
181720FTF0000
181820FTF0000
190020FTF0000
190120FTF0000
190320FTF0000
190520FTF0000
190820FTF0000
191120FTF0000
191420FTF0000
191520FTF0000
191720FTF0000
191920FTF0000
130632TFF0000
091032TFF0000
011861TFF0102
030161TFF0310
061861TFT1518
091561TFT0315
101561TFT1415
141161TFT1511
180861TFF1812
140373TFT0803