 static or mobile, X index, y index, type, vision, isEnemy, isWalkable, -- isVertical, eX, eY
1717
030110FTF0000
000220FTF0000
000020FTF0000
000720FTF0000
001420FTF0000
010020FTF0000
010520FTF0000
010920FTF0000
011320FTF0000
011720FTF0000
011920FTF0000
020120FTF0000
020620FTF0000
021120FTF0000
021520FTF0000
031820FTF0000
040020FTF0000
040420FTF0000
041220FTF0000
041620FTF0000
050320FTF0000
050420FTF0000
050620FTF0000
051520FTF0000
060020FTF0000
060120FTF0000
060520FTF0000
060820FTF0000
070120FTF0000
070320FTF0000
070420FTF0000
070520FTF0000
071520FTF0000
080020FTF0000
080320FTF0000
080420FTF0000
081420FTF0000
090120FTF0000
090420FTF0000
091320FTF0000
100120FTF0000
101120FTF0000
101420FTF0000
101520FTF0000
110020FTF0000
120120FTF0000
120320FTF0000
120420FTF0000
120920FTF0000
121520FTF0000
130120FTF0000
130220FTF0000
131020FTF0000
131320FTF0000
131420FTF0000
131520FTF0000
140020FTF0000
140620FTF0000
140720FTF0000
141320FTF0000
141420FTF0000
150020FTF0000
150120FTF0000
150320FTF0000
150420FTF0000
150720FTF0000
151420FTF0000
151520FTF0000
160120FTF0000
160220FTF0000
160620FTF0000
161520FTF0000
161620FTF0000
161820FTF0000
170020FTF0000
171720FTF0000
171820FTF0000
171920FTF0000
180120FTF0000
180320FTF0000
180420FTF0000
180620FTF0000
180920FTF0000
181020FTF0000
181220FTF0000
181320FTF0000
181520FTF0000
181620FTF0000
181720FTF0000
181920FTF0000
190020FTF0000
190120FTF0000
190220FTF0000
190420FTF0000
190520FTF0000
190620FTF0000
190720FTF0000
190920FTF0000
191220FTF0000
191420FTF0000
191620FTF0000
191820FTF0000
061432TFF0000
100932TFF0000
160732TFF0000
040261TFT0902
090561TFT1605
110161TFF1108
131961TFT1619
030373TFF0317
171673TFF1701
161773TFT0417