 static or mobile, X index, y index, type, vision, isEnemy, isWalkable, -- isVertical, eX, eY
171700FFF0000
060710FTF0000
000720FTF0000
001620FTF0000
001720FTF0000
001820FTF0000
001920FTF0000
010120FTF0000
010720FTF0000
010820FTF0000
011120FTF0000
011720FTF0000
011820FTF0000
011920FTF0000
020020FTF0000
021120FTF0000
021220FTF0000
021320FTF0000
021520FTF0000
021820FTF0000
021920FTF0000
030520FTF0000
031220FTF0000
031520FTF0000
031820FTF0000
051520FTF0000
060320FTF0000
061220FTF0000
061920FTF0000
070020FTF0000
071120FTF0000
071220FTF0000
071520FTF0000
071820FTF0000
081820FTF0000
090120FTF0000
091020FTF0000
100120FTF0000
101520FTF0000
101920FTF0000
111420FTF0000
111520FTF0000
111820FTF0000
111920FTF0000
120920FTF0000
130320FTF0000
130720FTF0000
131420FTF0000
140720FTF0000
140820FTF0000
141220FTF0000
141420FTF0000
141520FTF0000
151220FTF0000
151320FTF0000
160120FTF0000
161820FTF0000
161920FTF0000
170820FTF0000
171620FTF0000
180420FTF0000
180520FTF0000
191720FTF0000
080332TFF0000
090732TFF0000
101632TFF0000
160373TFF1613
020461TFT1304
100261TFF1013
011461TFT0814
081661TFT0416
041761TFT1217